#############__##############
#¨¨[$]¨¨¨¨¨¨......¨¨¨¨¨¨¨¨¨¨#
#¨¨¨¨¨¨¨¨¨¨.........¨¨¨¨[$]¨#
#.........................¨¨#
#........&.........&.....¨¨¨#
_............##.........¨¨¨¨_
_............##..........¨¨¨_
#........&.........&......¨¨#
#..........................¨#
#[H]¨¨¨¨¨¨¨¨¨¨¨¨¨¨¨¨¨.......#
#¨¨¨¨¨¨¨¨¨¨¨¨¨¨¨¨¨¨¨¨¨......#
#~~~~~~~~~~¨¨¨¨¨¨¨¨¨¨¨¨.....#
#~~~~~~~~~~~~¨¨¨¨¨¨¨¨¨¨¨¨[*]#
#~~~~~~~~~~~#################