########################################
#................[---].................#
#............[A].......[$].............#
#......................................#
#............[!].......[?].............#
#......................................#
#......................................#
#......................................#
#......................................#
#......................................#
#......................................#
#......................................#
#......................................#
#......................................#
#......................................#
#......................................#
#......................................#
#......................................#
#......................................#
########################################